before | conj. & prep. 在……之前; adv.以前
begin | v.开始
behave | v.表现、行为
behavior | n.行为
behind | prep.在……后面; adv.在后面
belief | n.相信
believe | v.相信
bell | n.铃声
belong | vi.应被放置
below | prep.在……下面
bend | vt. 使弯曲
beneath | prep.在……下方
benefit | n.益处 v.使受益
bent | adj.弯曲的; n.爱好
beside | prep. 在……旁边
besides | prep. 除……外 adv.还有
between | prep.在两者之间
beyond | prep.在……的那边
big | adj.大的
bike | n.自行车
bill | n.账单
bird | n.鸟
birth | n.出生
birthday | n.生日
birthplace | n.故乡
bit | n.一点
black | n.黑色 adj.黑色的
blackboard | n.黑板
blame | n. & v.责备
block | n.大块； vt.阻塞
blood | n.血液
blow | v.吹
blue | adj.蓝色的 ; n.蓝色
board | v.上 ; n.板子
boat | n.船
body | n.身体
bone | n.骨头
book | n.书 v.预定
border | n.边
bored | adj.烦
born | adj. 出生的
borrow | vt.借
boss | n.老板
both | n.双
bother | v.打搅
bottle | n.瓶子
bottom | n.底
bowl | n.碗
box | n.盒子
boy | n.男孩
brain | n.大脑
branch | n.分支
brave | adj.勇敢的
bravery | n.勇气
bread | n.面包
break | n.间隙 v.打破
breakfast | n. 早餐
breath | n.气息
breathe | vi.呼吸
ask | v.问；要求
asleep | adj. 睡着的
aspect | n. 方面
assistant | n.助手
astronaut | n.宇航员
at | prep. 在；因为；以
atmosphere | n.大气；气氛
attach | v.附上
attack | n. & vt. 攻击
attempt | n. & vt. 尝试；努力
attend | v.参加
attention | n. 注意
attitude | n. 态度
attract | v.吸引
attractive | adj. 有吸引力的
audience | n.观众
aunt | n.婶婶
author | n.作者
authority | n.权力
autumn | n.秋天
available | adj. 可用的
average | n. & adj.平均的
avoid | v.躲开
awake | v. & adj.醒的
award | v. & adj. 奖
aware | adj. 发觉
away | adv. 离开
awful | adj. 很坏的
baby | n. 婴儿
back | adv. 回; n. 背; adj.背后的
background | n. 背景
backward | adv. 向后
bad | adj. 坏的
bag | n.书包
balance | n. & vt. & vi. 平衡
ball | n. 球
band | n.乐队
bank | n.银行
bar | n.酒吧
base | n.基地； vt. 以……为基地
basic | adj. 基本的 
basis | n.基础
basket | n. 篮子
basketball | n.篮球
bath | n. 洗澡
bathe | v. 洗澡
bathroom | n.浴室
bathtub | n.浴缸
battle | n.战斗
be | v. 是
beach | n. 沙滩
bear | n.熊； v.忍受
beat | n. & v.打
beautiful | adj. 美的
beauty | n. 美
because | conj. 因为
become | v.变成
bed | n.床
bedding | n. 卧具
bedroom | n. 寝室
beer | n. 啤酒 




